ItemName	Descript
Item_Dan_IncreaseLife3	瓶装,延寿,淡黄色
Item_Dan_IncreaseLife4	葫芦装,延寿,蓝色
Item_Dan_Ling2	紫色,球型,根基
Item_Dan_IncreaseLife5	蓝色,球型,天劫
Item_Dan_IncreaseNeckCountdown1	葫芦,红色,天劫
Item_ParasolWood	木,坚硬,灵物
Item_Dan_PracticeSpeed	火,速度,瓶装
Item_Dan_Defense	护体,球型,橙色
Item_CopperBlock1	方,火,灵物
Item_Dan_CureHuoDamage	球型,疗伤,紫色
Item_Dan_CureTuDamage	球型,疗伤,橙色
Item_Dan_CureShuiDamage	粉末,水,蓝色
Item_Dan_CureMuDamage	球型,青色,疗伤
Item_Dan_CureFiveElementDamage	瓶装,疗伤,橙色
Item_EarthEssence_1	葫芦装,蓝色,疗伤
Item_Dan_FiveBaseFromLife	球型,紫色,折寿
Item_Dan_DredgeQi	瓶装,疗伤,土
Item_RedGinseng	根茎,红色,根基
Item_LingWood	木头,蓝色,灵物
Item_HardWood	木头,黄色
Item_Dan_PracticeRate	小颗粒,金,瓶颈
Item_Dan_IncreaseLife1	延寿,葫芦装,木
Item_Dan_IncreaseLife2	延寿,粉末,水
Item_BasePracticeDrug	五维,瓶装,水
Item_LingMuXueJie	精元,粉末,蓝色
Item_Dan_CalmDown	心境,小颗粒,蓝色
Item_Dan_Happiness	褐色,心境,小颗粒
Item_Dan_FiveBase2	五维,土,瓶装
Item_Dan_FiveBase1	五维,瓶装,金色
Item_Dan_FiveBase3	火,五维,瓶装
Item_Dan_FiveBase4	木,五维,瓶装
Item_Dan_FiveBase5	水,五维,瓶装
Item_Dan_IncreaseNeckCountdown2	粉末,天劫,金
Item_Dan_CureJinDamage	盒子,白色,疗伤
Item_ShuiEssence	白色,圆形,灵物
Item_HuoEssence	火,球型,灵物
Item_JinEssence	褐色,球型,灵物
Item_MuEssence	褐色,灵物,木
Item_TuEssence	褐色,土,灵物
Item_LifeStream	液体,延寿,无色
Item_EarthEssence	液体,无色,根基
Item_SkyStone	石头,灵物,土
Item_StarEssence	灵物,石头,金
Item_SoulPearl	灵物,水,球型
Item_EarthEssence1	根基,液体,红色
Item_Dan_LongDan1	蓝色,球型,水
Item_Dan_FengDan1	红色,球型,火
Item_YanDaoGuo	道行,木,紫色
Item_QieDaoGuo	天谴,木,蓝色
Item_Dan_TreeEXP	球型,无色,参悟
Item_Dan_ExtremeLofty	葫芦装,金色,疗伤
Item_ExtremeJade	坚硬,蓝色,灵物
Item_XianDaoShenNian	球型,潜力,绿色
Item_XianDaoXieNian	球型,潜力,紫色
Item_Dan_HundredRefine	金色,球型,修为
Item_Dan_ZhuLongDan1	分神,彩色,球型
Item_ThunderAir	球型,无法食用,天劫
Item_XianBone	骨头,道行,无五维
Item_ZaoHuaYuZi	青色,无五维,精华
Item_Dan_LingYuanZhong	青色,灵物,无五维
Item_Dan_ReBorn_4	球型,红色,延寿
Item_BenYuan_None	无五维,道行,精华
Item_BenYuan_Jin	金色,道行,精华
Item_BenYuan_Mu	绿色,道行,精华
Item_BenYuan_Shui	蓝色,道行,精华
Item_BenYuan_Huo	红色,道行,精华
Item_BenYuan_Tu	褐色,道行,精华
Item_Yao_RabbitLuck	水,毛茸茸
Item_Yao_WolfAtk	金,坚硬
Item_Yao_SnakeHanLin	水,坚硬
Item_Yao_BearPiMao	火,毛茸茸
Item_Yao_TurtleKe	坚硬,土
Item_BoarMeat	土,棕色,食物
Item_StrangeMush	木,棕色,食物
Item_MillVell	木,毛茸茸
Item_SewingDefender	木,坚硬
Item_PerfumeBag	木,心境
Item_StoneCutter	金,速度
Item_Handkerchief	毛茸茸,无五维
Item_Bracelet	坚硬,无五维
Item_SmallBell	坚硬,无五维
Item_SysAxe	坚硬,无五维
Item_SysPickaxe	坚硬,无五维
Item_SysSickle	坚硬,无五维
[ANIMAL]	盒子,方型
Item_BossFeng_TouYu	火,毛茸茸,凶兽
Item_BossFeng_WeiYu	毛茸茸,凶兽,灵物
Item_BossFeng_HongYu	参悟,凶兽,红色
Item_BossLong_Jiao	凶兽,坚硬,御剑
Item_BossLong_NiLin	参悟,水,凶兽
Item_BossLong_Jing	坚硬,灵物,凶兽
Item_BossZhuLong_Eye	凶兽,球形
Item_BossZhuLong_LongYu	混沌,抗性,凶兽
Item_BossZhuLong_TianLin	护体,凶兽
Item_Dan_FenShen1	盘古,红色,分神
Item_Dan_FenShen2	造化,红色,分神
Item_Dan_FenShen3	心境,红色,分神
Item_Yao_CatSoul	球形,蓝色,分神
Item_WhiteHair	书,蓝色,白色
Item_BossFeng_HuoYu	灵物,红色,凶兽
Item_BossFeng_GangYu	火,凶兽
Item_BossFeng_Gu	骨头,坚硬,凶兽
Item_DragonScale	蓝色,灵物,凶兽
Item_BossLong_Zhua	尖锐物,凶兽
Item_BossLong_Lin	蓝色,防御,凶兽
Item_BossZhuLong_BaiLin	白色,凶兽
Item_BossZhuLong_HeiLin	黑色,凶兽
Item_BossFeng_Meat	食物,凶兽,红色
Item_BossLong_Meat	食物,杂色,凶兽
Item_BossZhuLong_Meat	道行,食物,凶兽
Item_Dan_Restore	疗伤,黄色,粉末
Item_Dan_SwordBall	球形,蓝色
Item_Dan_Ling3	粉末,黄色
Item_Dan_Thin	颗粒,蓝色,容貌
Item_Dan_FaceLock	颗粒,红色,容貌
Item_Dan_FaceUnLock	颗粒,土,容貌
Item_Dan_Soul1	颗粒,参悟,寿元
Item_Dan_Soul2	颗粒,火,参悟
Item_Dan_Soul3	颗粒,土,参悟
Item_Dan_Soul4	颗粒,悟性,参悟
Item_QiZhi	开智,瓶装,水
Item_Fall_LingZhi	开智,瓶装,金
Item_Winter_LingZhi	开智,瓶装,冬
Item_Spring_LingZhi	开智,瓶装,木
Item_Summer_LingZhi	开智,瓶装,火
Item_Earth_LingZhi	开智,瓶装,土
Item_SoulCrystalYou	珀,无五维,痛苦
Item_SoulCrystalNing	珀,无五维,宁静
Item_SoulCrystalLing	珀,无五维,幸福
Item_GodPractice_MiJuan	书,无五维
Item_PurpleGanodermaLucidum	紫色,灵物,食物
Item_HorseFromFei	毛茸茸,无五维,水
Item_HorseFromLuShu	毛茸茸,无五维,火
Item_WuDang_HuangJingFen	粉末,白色,木
Item_Dan_WuQiNoHunger2	球型,食物,木
Item_Dan_SanHuaHuangJing	木,灵气,黄色